AAAAAAAAAAAAABBBBBBBB
C      D            D
C      D            D
C      DKL   MNO    D
C                   D
C    P              D
C    Q              D
C    S              D
C    V    W         D
C                   D
C                   D
GGGGHHHHHIIIIIIIJJJJJ